######################
# E    P##########K###
#### ##    ####P     #
####K##### ##    ### #
####  M#########   #F#
######################