######################
# E     ####M#####K###
#  # ##    # #P    # #
## # ####       # ## #
##K#  M##P #K####   F#
######################