######################
#MK##P  #####K   #####
#         K#      M###
#  ####      #### ####
#E###M   #M    P##  F#
######################